  -> ó
à -> ô
á -> õ
â -> û
ã ->  
ä -> è
å -> ø
æ -> ñ
ç -> ÷
è -> ï
é -> í
ê -> ò
ë -> à
ì -> é
í -> æ
î -> ú
ï -> ç
ð -> ã
ñ -> ì
ò -> á
ó -> ð
ô -> ù
õ -> ü
ö -> -
÷ -> â
ø -> ý
ù -> -
ü -> î
ú -> -
û -> ë
ý -> þ
þ -> ö
ÿ -> ä