  -> у
а -> ф
б -> х
в -> ы
г ->  
д -> и
е -> ш
ж -> с
з -> ч
и -> п
й -> н
к -> т
л -> а
м -> й
н -> ж
о -> ъ
п -> з
р -> г
с -> м
т -> б
у -> р
ф -> щ
х -> ь
ч -> в
ш -> э
ь -> о
ы -> л
э -> ю
ю -> ц
я -> д
